###############
#!!#,,,,,,,#!$#
#,!#,,,#!!,#,!#
#,,#,,!#,,,#,,#
#!,,,,,#,,,,,,#
#!,,###########
#!!,,,,,,!!,,,#
#!,,,,!!,,,,,O#
#,,,,,,!#######
#$,,!,,,,!!!,,#
##########!!,,#
#,,,,!,,!!,,,!#
#,,,###########
#!!,,,,!,,,,!$#
###############