###############
#,!!!,,,!!,,,O#
#,,,##,,,###,,#
#,$,,!,,!!,,,!#
####,,,,,,#####
#,,!!,,,!!!,,,#
#,,,,!!,!!!,,!#
#!,,########,,#
#,!!,,,,!,,!,,#
#,,####,,,,,!$#
#!,,,!!,,,,,###
#,,!!,,,$!!,,,#
#,,!,,,########
#,,,,,,!!!,,,,#
###############