###############
#,,,,,!!,,,,,$#
#,#,###,###,#,#
#,#,,,,!,,,!,!#
#,#,#######,#,#
#,,!!,,,!!,####
#####,,#####,O#
#,,!,,,,,,,!,,#
#,$,!!,,!!,,,,#
#,#######,###,#
#,#,,,,!!,,,,,# 
#,,,,!,,,,,,!!#
#,,,,!!!,,,!!!#
#,,,!!!,,!,!!,#
###############