###############
#,,,,,!!,,$!!,#
#,#,###,###!#,#
#,#,,,,!,,,,,!#
#,#,#######,#,#
#,,!!,,,!!,####
#####,,#####,O#
#,,!,,,,,,,!,,#
#,$,!!,,!!,,,,#
#,#######,###,#
#,#,,,,!!,,,,,# 
#,,,,!,,,,,,!!#
#,,,,!!!,,,!!!#
#,,,!!!,,!,!!,#
###############