###############
#!!,,,,,#,,,!!#
#,!,,,,$#!,,,!#
#,,,,,!!#,,,,,#
#!,,,,,,#,,,,,#
#!,,,!!!,,,####
#!!,,,,,,!!,,,#
#!,,,,!!,,,,,O#
#,,,,,,!,,,,,!#
#$,,,!,,,,!!!,#
#######,,,,!,,#
#,,,,#,,!!,,,!#
#,,,,#,,,!,,,,#
#!!,,,,!,,,,!,#
###############